 __________________________________________
|                                          |
|                    (@)                   |
|                   Kermy                  |
|                 _________                |
|                |Password@|               |
|                                          |
|                                          |
|                                          |
|                                          |
|__________________________________________|
