;;;;;;;;;;;;;;;;;;;;;;;;;;;
;;;;;;;;;;;;;;;;;;;;;;;;;;;
;;;;;;;;;;;;;;;;;;;;;;;;;;;
;;;;;;;;;;;,---.;;;;;;;;;;;
;;;;;;;;;;/`---'\;;;;;;;;;;
;;;;;;;;;/       \;;;;;;;;;
;;;;;;;;/         \;;;;;;;;
;;;;;;;;`-._____.-';;;;;;;;
;;;;;;;;;;;;( );;;;;;;;;;;;
;;;;;;;;;;;;) ( ;;;;;;;;;;;
;;;;;;;;;;.-(_)-.;;;;;;;;;;
;;;;;;;;;;'=====';;;;;;;;;;
;;;;;;;;;;;;;;;;;;;;;;;;;;;
