(IIIIIIIIIIIIIIIIIII)
)'.'.'.':;:;:'.'.'.'(
('.'.'.;' | `:.'.'.')
)'.'.';'  |  `:'.'.'(
('.'.;'   |   `:.'.')
)'.';'____|____`:'.'(
(==@'     |     `@==)
)'.:      |      :.'(
('.'.     |     .'.')
)'.'.     |     .'.'(
('.'.     |     .'.')
)'.'.     |     .'.'(
('.'._____|_____.'.')
)'.'============='.'(
('.'             '.')
